map.define("Wilderness")

map.wild.map
{
[[XXXXXXXXXXXXXXXXXXXXXXXXXXXXXXXXXXXXXXXXXXXXXXXXX]],
[[X...............................................X]],
[[X.......................E.......................X]],
[[X...............................................X]],
[[X...............................................X]],
[[X...............................................X]],
[[X...789.........................................X]],
[[X...456.........................................X]],
[[X...123.........................................X]],
[[X.........................F.....................X]],
[[X...............................................X]],
[[X...............................................X]],
[[X...............................................X]],
[[X.............CD................................X]],
[[X.............AB................................X]],
[[X...............................................X]],
[[X...........................................G...X]],
[[X...............................................X]],
[[XXXXXXXXXXXXXXXXXXXXXXXXXXXXXXXXXXXXXXXXXXXXXXXXX]],

}

-- Starting position
map.wild.start(7, 5)
