map.define("birdcave.map")

-- Floor
map.symbol{ symbol='.' feat=FEAT_DIRT info=6 }

-- Permanent wall
map.symbol{ symbol='X' feat=FEAT_GROTTO info=6 }

-- The Hikui Bird
map.symbol{ symbol='a' feat=FEAT_DIRT info=6 monster=RACE_HIKUI_BIRD }

-- Back to Mount Frypan
map.symbol{ symbol='<' feat=FEAT_LESS info=6 dungeon=DUNGEON_OXKING_HOUSE }

-- Dungeon layout
map.map
{
[[XXXXXXXXXXXXXXXXXXXXXXXXXXXXXXXXX]],
[[XXXXXXXX....XXXXXXXXXXX......XXXX]],
[[XXXXX.........XXXXXXX..........XX]],
[[XXX..........XXXXXX.........a...X]],
[[XX..........XXXX................X]],
[[XXXX....XXXXXXX..XX.............X]],
[[XXXXXXX...XXXXXX..XXXXXX.......XX]],
[[XXXXXXXXX.....XXX..XXXX.......XXX]],
[[XXX...XXX..XX..XXX.XXX...XXXXXXXX]],
[[XX..X..XXX..XX.....XXX.XXXX....XX]],
[[X..XXX.XXXX..XXXXXXXXX..XX..XX..X]],
[[X.XXXX..XXXX..XXXXXXXXX....X...XX]],
[[X..XXXX...XX..XXXXXXXXXXX.X..XXXX]],
[[XX..XXXXX....XXX.......XXXXX...XX]],
[[XXX..XXXXXXXXX..........XXXXXX..X]],
[[XXX..XXXXXXX.............XXXXXX.X]],
[[XX..XXXXXXX................XXX..X]],
[[X.......XXX..X.........XX..XX..XX]],
[[X.<...X..X..XXXXX.....XXXX....XXX]],
[[X...XXXX...XXXXXXXXXXXXXXXXXXXXXX]],
[[XXXXXXXXXXXXXXXXXXXXXXXXXXXXXXXXX]],
}

-- Starting position
map.set_player(18, 2)
