-- Dragonball T: Orinji Temple

map.define("temple.map")

map.symbol{ symbol='.' feat=FEAT_FLOOR info=6 }
map.symbol{ symbol='<' feat=FEAT_LESS info=6 inventory_size=0 }
map.symbol{ symbol='*' feat=FEAT_MAP_BORDER info=6 }
map.symbol{ symbol='X' feat=FEAT_PERMA_WALL info=6 }
map.symbol{ symbol='g' feat=FEAT_FLOOR info=6 monster=RACE_BUDDHIST_MONK }
map.symbol{ symbol='h' feat=FEAT_FLOOR info=6 monster=RACE_MEDITATING_MONK }
map.symbol{ symbol='i' feat=FEAT_FLOOR info=6 monster=RACE_KRILLAN }

map.map
{
[[*******************************************]],
[[*XXXXXXXXXXXXXXXXXXXXXXXXXXXXXXXXXXXXXXXXX*]],
[[*XXXXXXXXXXXXXXXXXXXXXXXXXXXXXXXXXXXXXXXXX*]],
[[*XXXXXXXXXXXXXXXXXX...XXXXXXXXXXXXXXXXXXXX*]],
[[*XXXXXXXXXXXXXXXXX.XXX.XXXXXXXXXXXXXXXXXXX*]],
[[*X...XX...XX...XX.XXXXX.XX...XX...XX...XXX*]],
[[*X.h.XX...XX...XX.XXXXX.XX...XX.i.XX...XXX*]],
[[*X...XX...XX...X.........X...XX...XX...XXX*]],
[[*XX.XXXX.XXXX.XX..g...g..XX.XXXX.XXXX.XXXX*]],
[[*X.....................................XXX*]],
[[*XX.XXXX.XXXX.XX.........XX.XXXX.XXXX.XXXX*]],
[[*X...XX...XX...X.........X...XX...XX...XXX*]],
[[*X...XX...XX.h.XX.......XX.h.XX...XX.h.XXX*]],
[[*X...XX...XX...XX.......XX...XX...XX...XXX*]],
[[*XXXXXXXXXXXXXXXXX.....XXXXXXXXXXXXXXXXXXX*]],
[[*XXXXXXXXXXXXXXXXX.....XXXXXXXXXXXXXXXXXXX*]],
[[*XXXXXXXXXXXXXXXXXX...XXXXXXXXXXXXXXXXXXXX*]],
[[*XXXXXXXXXXXXXXXXXX...XXXXXXXXXXXXXXXXXXXX*]],
[[*XXXXXXXXXXXXXXXXXX...XXXXXXXXXXXXXXXXXXXX*]],
[[*XXXXXXXXXXXXXXXXXX...XXXXXXXXXXXXXXXXXXXX*]],
[[*XXXXXXXXXXXXXXXXXX...XXXXXXXXXXXXXXXXXXXX*]],
[[*XXXXXXXXXXXXXXXXXX...XXXXXXXXXXXXXXXXXXXX*]],
[[*XXXXXXXXXXXXXXXXXX...XXXXXXXXXXXXXXXXXXXX*]],
[[*XXXXXXXXXXXXXXXXXX.<.XXXXXXXXXXXXXXXXXXXX*]],
[[*XXXXXXXXXXXXXXXXXXXXXXXXXXXXXXXXXXXXXXXXX*]],
[[*******************************************]],
}

map.set_player(23, 20)

map.level_size_to_map()
