map.define("earth3.map")

-------------------------------------------------------------------------------
-- Terrain
-------------------------------------------------------------------------------
map.symbol{ symbol='=' feat=FEAT_GRASS info=3 }
map.symbol{ symbol='^' feat=FEAT_MOUNTAIN info=3 }
map.symbol{ symbol='#' feat=FEAT_BUILDING info=6 }
map.symbol{ symbol='T' feat=FEAT_TREES info=3 }
map.symbol{ symbol='W' feat=FEAT_DEEP_WATER info=3 }
map.symbol{ symbol='V' feat=FEAT_SHAL_WATER info=3 }
map.symbol{ symbol=',' feat=FEAT_DIRT info=3 }
map.symbol{ symbol='.' feat=FEAT_ASH info=3 }
map.symbol{ symbol='?' feat=FEAT_SAND info=3 }
map.symbol{ symbol='L' feat=FEAT_VOLC_LAVA info=3 }

-------------------------------------------------------------------------------
-- Dungeons
-------------------------------------------------------------------------------
map.symbol{ symbol='a' feat=FEAT_MORE info=3 dungeon=DUNGEON_OXKING_HOUSE }
map.symbol{ symbol='b' feat=FEAT_MORE info=3 dungeon=DUNGEON_VOLCANO }


-------------------------------------------------------------------------------
-- Map Specific Misc
-------------------------------------------------------------------------------
map.quest_symbol
{
	quest = QUEST_RING_OF_FIRE
	symbol = 'z'
	symbols =
	{
		[{QUEST_STATUS_FINISHED}] = { feat=FEAT_MOUNTAIN info=3 }
		default = { feat=FEAT_DIRT info=3 monster=RACE_OXKING }
	}
}

map.map
{
[[==TTTTTTTTTTTTTTTTTTTTTTTTTTTTTTTTTTTTTTTTTTTTTTTTTTTTTTTTTTTTTTTTTTTTTTTTTTTTTTTTTTTTTTTTTTTTTTTTTTTTTTTTTTTTTTTTTTTTTTTTTTTTTTTT====================================================================]],
[[===TTTTTTTTTTTTTTTTTTTTTTTTTTTTTTTTTTTTTTTTTTTTTTTTTTTTTTTTTTTTTTTTTTTTTTTTTTTTTTTTTTTTTTTTTTTTTTTTTTTTTTTTTTTTTTTTTTTTTTT============================================================================]],
[[========TTTTTTTTTTTTTTTTTTTTTTTTTTTTTTTTTTTTTTTTTTTTTTTTTTTTTTTTTTTTTTTTTTTTTTTTTTTTTTTT==============================================================================================================]],
[[==========TTTTTTTTTTTTTTTTTT==========================================================================================================================================================================]],
[[======================================================================================================================================================================================================]],
[[======================================================================================================================================================================================================]],
[[======================================================================================================================================================================================================]],
[[=======================================????????????????===============================================================================================================================================]],
[[=================??????????????????????????????????????????????????????===============================================================================================================================]],
[[====???????????????????????????????????????????????????????????????????????===========================================================================================================================]],
[[????????????????????????????????????????????????????????????????????????????===??=====================================================================================================================]],
[[???????????????????????????????????????????????????????????????????????????????????===================================================================================================================]],
[[???????????????????????????????????????????????????????????????????????????????????????===============================================================================================================]],
[[???????????????????????????????????????????????????????????????????????????????????????===============================================================================================================]],
[[??????????????????????????????????????????????????????????????????????????????????????==========================================,,,===================================================================]],
[[??????????????????????????????????????????????????????????????????????????????????????=========================================,^^^,==================================================================]],
[[?????????????????????????????????????????????????????????????????????????????????????=========================================,^^a^^,=================================================================]],
[[???????????????????????????????????????????????????????????????????????????????===============================================,,,,z^,=================================================================]],
[[???????????????????????????????????????????????????????????????????????????????????===========================================,^^,^^,=================================================================]],
[[??????????????????????????????????????????????????????????????????????????????????=============================================,^^^,==================================================================]],
[[????????????????????????????????????????????????????????????????????????????????????============================================,,,===================================================================]],
[[??????????????????????????????????????????????????????????????????????????????????????================================================================================================================]],
[[?????????????????????????????????????????????????????????????????????????????????????????===================================^^========================================================================]],
[[???????????????????????????????????????????????????????????????????????????????????????????===========================================================================================================]],
[[??????????????????????????????????????????????????????????????????????????????????????????????????==========================================================================================WWWWWWWWWW]],
[[???????????????????????????????????????????????????????????????????????????????????????????????????????===??===============^============================================================WWWWWWWWWWWWWW]],
[[???????????????????????????????????????????????????????????????????????????????????????????????????????????========================================================================WWWWWWWWWWWWWWWWWWW]],
[[??????????????????????????????????????????????????????????????????????????????????????????????????????????===============^^======================================================WWWWWWWWWWWWWWWWWWWWW]],
[[????????????????????????????????????????????????????????????????????????????????????????????????????????==============^^^^====================================================WWWWWWWWWWWWWWWWWWWWWWWW]],
[[????????????????????????????????????????????????????????????????????????????????????????????????????????===============^====================================================WWWWWWWWWWWWWWWWWWWWWWWWWW]],
[[???????????????????????????????????????????????????????????????????????????????????????????????????????????===========^===================================================WWWWWWWWWWWWWWWWWWWWWWWWWWWW]],
[[??????????????????????????????????????????????????????????????????????????????????????????????????????????????=======^^================================================WWWWWWWWWWWWWWWWWWWWWWWWWWWWWWW]],
[[????????????????????????????????????????????????????????????????????????????????????????????????????????????=======^^^^==============================================WWWWWWWWWWWWWWWWWWWWWWWWWWWWWWWWW]],
[[???????????????????????????????????????????????????????????????????????????????????????????????????????????====^^^^^^^=============================================WWWWWWWWWWWWWWWWWWWWWWWWWWWWWWWWWWW]],
[[????????????????????????????????????????????????????????????????????????????????????????????????????????==^^^^^^^^^^^^^^^^^=======================================WWWWWWWWWWWWWWWWWWWWWWWWWWWWWWWWWWWW]],
[[??????????????????????????????????????????????????????????????????????????????????????????????????^^^^^^^^^^^^^^^^^^^^^^^^^^^^^^^^===============================WWWWWWWWWWWWWWWWWWWWWWWWWWWWWWWWWWWWW]],
[[????????????????????????????????????????????????????????????????????????????????????????????????????^^^^^^^^..............^^^^^^^^^^^^^==========================WWWWWWWWWWWWWWWWWWWWWWWWWWWWWWWWWWWWW]],
[[?????????????????????????????????????????????????????????????????????????????????????????????^^^^^^^^^^^^...................^^^^^^^^^^^^^=======================WWWWWWWWWWWWWWWWWWWWWWWWWWWWWWWWWWWWWW]],
[[???????????????????????????????????????????????????????????????????????????????????????^^^^^^^^^^^^^^............^............=^^^^^^^^^^=======================WWWWWWWWWWWWWWWWWWWWWWWWWWWWWWWWWWWWWW]],
[[?????????????????????????????????????????????????????????????????????????????????????^^^^^^^^^===..............^^^^^...........=^^^^^^^^^^=======================WWWWWWWWWWWWWWWWWWWWWWWWWWWWWWWWWWWWW]],
[[???????????????????????????????????????????????????????????????????????????????^^^^^^^^^^^^^^^^^====..........^^^b^^^..........==^^^^^^^^^^^=======================WWWWWWWWWWWWWWWWWWWWWWWWWWWWWWWWWWW]],
[[???????????????????????????????????????????????????????????????????????????^^^^^^^^^^^^^===============........^^L^^..........==^^^^^^^^^^==========================WWWWWWWWWWWWWWWWWWWWWWWWWWWWWWWWWW]],
[[?????????????????????????????????????????????????????????????????????????^^^^^^^^^^^^==================..........L..........==^^^^^^^^^^^^^^^^=======================WWWWWWWWWWWWWWWWWWWWWWWWWWWWWWWWW]],
[[???????????????????????????????????????????????????????????????????^^^^^^^^^^^^^^^====================...........LL.......===^^^^^^^^^^^^^===========================WWWWWWWWWWWWWWWWWWWWWWWWWWWWWWWWW]],
[[????????????????????????????????????????????????????????????^^^^^^^^^^^^^^^^^^^====================............LLLL......==^^^^^^^^^^^^^^=============================WWWWWWWWWWWWWWWWWWWWWWWWWWWWWWWW]],
[[????????????????????????????????????????????????^^^^^^^^^^^^^^^^^^^^^^^^^=================^^^^^^^^^^^^^^^.....LLLLLLLL^^^^^^^^^^^^^^==================================WWWWWWWWWWWWWWWWWWWWWWWWWWWWWWWW]],
[[?????????????????????????????????????^^^^^^^^^^^^^^^^^^^^^^^^^^^^^^^^^========================^^^^^^^^^^..LLLLLLLL^^^^^^^^^^^^^^^^^^^^=================================WWWWWWWWWWWWWWWWWWWWWWWWWWWWWWW]],
[[??????????????????????????^^^^^^^^^^^^^^^^^^^^^^^^^^^^^^^^^^^^^======================================^^^^^^^^^^^^^^^^^^^^^^^^===========================================WWWWWWWWWWWWWWWWWWWWWWWWWWWWWW]],
[[??????????????????????????????=========================================================================^^^^^^^^^^^^^^^^^^===============================================WWWWWWWWWWWWWWWWWWWWWWWWWWWWWW]],
[[???????????????????????==================================================================================^^^^^^^^^^^^^^^^==============================================WWWWWWWWWWWWWWWWWWWWWWWWWWWWWWW]],
[[????????????????==================??========================================================================^^^^^^^^^^^^=============================================WWWWWWWWWWWWWWWWWWWWWWWWWWWWWWWWW]],
[[???????????????????????????????????????========================================================================^^^^^^^^^===========================================WWWWWWWWWWWWWWWWWWWWWWWWWWWWWWWWWWW]],
[[??????????????????????????????????????===========================================================================^^^^^=======================================WWWWWWWWWWWWWWWWWWWWWWWWWWWWWWWWWWWWWWWWW]],
[[????????????????????????????????????============================================================================^^^^^^^^==================================WWWWWWWWWWWWWWWWWWWWWWWWWWWWWWWWWWWWWWWWWWWW]],
[[???????????????????????????????????============^^^^^^^^^^==================================================^^^^^^^^^^===================================WWWWWWWWWWWWWWWWWWWWWWWWWWWWWWWWWWWWWWWWWWWWWW]],
[[???????????????????????????????===================^^^^^^^^^^^^^========================================^^^^^^^^^^^^^===================================WWWWWWWWWWWWWWWWWWWWWWWWWWWWWWWWWWWWWWWWWWWWWWW]],
[[???????????????????????===============================^^^^^^^^^^^^^^^^^^^^^^^^^^^^^======================^^^^^^^^^^====================================WWWWWWWWWWWWWWWWWWWWWWWWWWWWWWWWWWWWWWWWWWWWWWW]],
[[????????????????????????==================================^^^^^^^^^^^^^^^^^^^^^^^========================^^^^^^^^^^^===================================WWWWWWWWWWWWWWWWWWWWWWWWWWWWWWWWWWWWWWWWWWWWWWW]],
[[???????==========????????????===============================^^^^^^^^^^^^^^^^===========================^^^^^^^^^^^====================================WWWWWWWWWWWWWWWWWWWWWWWWWWWWWWWWWWWWWWWWWWWWWWWW]],
[[=======================?????==============================^^^^^^^^^^==================================^^^^^^^^^^^^====================================WWWWWWWWWWWWWWWWWWWWWWWWWWWWWWWWWWWWWWWWWWWWWWWW]],
[[======================================================^^^^^^^^^^^====================================^^^^^^^^^^^=====================================WWWWWWWWWWWWWWWWWWWWWWWWWWWWWWWWWWWWWWWWWWWWWWWWW]],
[[==================================================^^^^^^^^^^^^^^====================================^^^^^^^^^^======================================WWWWWWWWWWWWWWWWWWWWWWWWWWWWWWWWWWWWWWWWWWWWWWWWWW]],
[[==============================================^^^^^^^^^^^^^^^^^^^^^================================^^^^^^^========================================WWWWWWWWWWWWWWWWWWWWWWWWWWWWWWWWWWWWWWWWWWWWWWWWWWWW]],
[[==========================================^^^^^^^^^^^^^^^^^^^^^^^^^^^^^===========================^^^^^^^====================================WWWWWWWWWWWWWWWWWWWWWWWWWWWWWWWWWWWWWWWWWWWWWWWWWWWWWWWWW]],
[[=====================================^^^^^^^^^^^^^^^^^^^^^^^^^^^^^^^^^^^^^=====================^^^^^^^^^=================================WWWWWWWWWWWWWWWWWWWWWWWWWWWWWWWWWWWWWWWWWWWWWWWWWWWWWWWWWWWWW]],
[[==================================^^^^^^^^^^^^^^^^^^^^^^^^^^^^^^^^^^^^^^^^^^^=================^^^^^^^^^^=============================WWWWWWWWWWWWWWWWWWWWWWWWWWWWWWWWWWWWWWWWWWWWWWWWWWWWWWWWWWWWWWWWW]],
}
