map.define("frozen.map")

map.symbol{ symbol='X' feat=FEAT_ICE_WALL info=6 }

map.symbol{ symbol=',' feat=FEAT_DIRT info=3 }
map.symbol{ symbol='.' feat=FEAT_SNOW info=3 }
map.symbol{ symbol='I' feat=FEAT_ICE_WALL info=3 }
map.symbol{ symbol='B' feat=FEAT_PERMA_WALL info=3 }
map.symbol{ symbol='T' feat=FEAT_TREES info=3 }
map.symbol{ symbol='^' feat=FEAT_MOUNTAIN info=3 }
map.symbol{ symbol='S' feat=FEAT_SNOWY_PEAK info=3 }
map.symbol{ symbol='-' feat=FEAT_GRASS info=3 }
map.symbol{ symbol='<' feat=FEAT_LESS info=6 }
map.symbol{ symbol='>' feat=FEAT_MORE info=6 }

map.symbol{ symbol='a' feat=FEAT_SIGNPOST info=6 on_walk="Beware of wolves" }
map.symbol{ symbol='b' feat=FEAT_SIGNPOST info=6 on_walk="The sign reads 'Crane Hermit'" }
map.symbol{ symbol='c' feat=FEAT_MORE info=6 dungeon=DUNGEON_WOLFCAVE }


-- Dungeon layout
map.map
{
[[XXXXXXXXXXXXXXXXXXXXXXXXXXXXXXXXXXXXXXXXXXXXXXXXXXXXXXXXXXXXXXXXXXXXXXXXXXXXXXXXXXXXXXXXXXXXXXXXXXXXXXXXXXXXXXX]],
[[XSSSSSSSSS.....................................................................................SSSSSSSSSSSSSSSS]],
[[XSIIIIIISS....................................................................................SS.........TSSSSS]],
[[XSI..cIISS..................................................................................SSS...T..BBB...TTSS]],
[[XII.IIISS................................................................................SSSS........BBB....TSS]],
[[XI...ISSS..............................................................................SSSS....T..T..B>B....SSS]],
[[XI......SS...........................................................................SSSS...................SSS]],
[[X........SSSSSS..................................................................SSSSSSSSSS...............SSSSS]],
[[X...........SSS........................................................................SSSSS.........T.SSSSSSSS]],
[[X.............................................................................SSSSSSSSSSSS....b...SSSSSSSSSSSSS]],
[[X...........................................................................SSSSSSSSSS......SSSSSSSSSSSSSII..IX]],
[[X.........................................................................................SSSSSSSSSS..........X]],
[[X.....................................................................................SSSSSSSSS..............IX]],
[[X................................................................................SSSSSSSSSSS..............IIIIX]],
[[X......................................................................................................SSSSSSSX]],
[[X...................................................................................................SSSSSSSSSXX]],
[[X..................................................................................................SSSSSSSSSXXX]],
[[X................................................................................................SSSSSSSSSSXXXX]],
[[X..............................................................................................SSS.......XXXXXX]],
[[X..............................................................................................SS..........XXXX]],
[[X........................................................................................SSSSSS.............XXX]],
[[X..........................................................................................II................XX]],
[[X.............................................................................................................X]],
[[X.............................................................................................................X]],
[[X...........................................................................................T.................X]],
[[X...............................................................................................T....III.....XX]],
[[X...............................................................................IIII..,.,..,,.,TSSSS......I...X]],
[[X..............................................................................III^..,,.,.,.,,.,,S^^^.....T...X]],
[[X.............................................................................IISS^^^.,,,,.,,,,,,,,^^^^^.....^X]],
[[X........................................................................IIIIIISS^^^^^,,.,,,,,,,,,,,,,^^^..^^^X]],
[[X...................................................................IIIIIISSSSSSSS^^^^^,,,,,,,,,,,,,,,,^^^^^^^X]],
[[X......................................................................IIIIIIIIIIII^^^^^,,^^,,,,,,,,,,,,,^^^^^X]],
[[X................................................................................III^^^^^,^^,,,,T,,,,,,,,T^^^^X]],
[[X..................................................................................III^^^^^^,,,,,,,,,,,,,,,^^^^]],
[[X....................................................................................II^^^^^,,,,,,,,,,,,,,,,^^^]],
[[X.....................................................................................II^^^^^,,,,,,,,,,,T,,T^^^]],
[[X......................................................................................II^^^^,,,,,,,,,,,,,,,^^^]],
[[X.....................................................................................III^^^^T,,,,,T,,,,,a,,^^^]],
[[X...................................................................................IIII^^^^^^,,,,,,,,,,,,,,,^^]],
[[X...............................................................................IIIIII^^^SS^^^^,,,,,,,,,-,-,,-^]],
[[X.........................................................................IIIIIIII^^^^^SSS^^^^^T,,,,,,-,--,<--T]],
[[X...............................................................IIIIIIIIIIII^^^^^^^^^^^^^^^^^^^^,,,,---T,-----T]],
[[XXXXXXXXXXXXXXXXXXXXXXXXXXXXXXXXXXXXXXXXXXXXXXXXXXXXXXXXXXXXXXXXXXXX^^^^^^^^^^^^^^^^^^^^^^^^^^^^^^^^^^TTTTTTTTT]],
}

map.level_size_to_map()

-- Starting position
if dball_data.level_tracker == 1 then
	-- map.set_player(5, 86)
else
	map.set_player(40, 90)
end
