-- Dragonball T: The Hidden, Secret, DEEP Laboratory of Dr. Gero

map.define("gerolab.map")

map.symbol{ symbol='.' feat=FEAT_DISQUALIFIED info=6 }

map.symbol{ symbol='^' feat=FEAT_DEEP_LAVA info=0 trap=map.ANY }
map.symbol{ symbol='X' feat=FEAT_PERMA_WALL info=6 }
map.symbol{ symbol='<' feat=FEAT_LESS info=8 }
map.symbol{ symbol='D' feat=FEAT_DOOR_LOCKED_HEAD+6 info=6 inventory_size=0  }
map.symbol{ symbol='a feat=FEAT_FLOOR  info=3 monster=RACE_WHIRLIGIG }

-- Fast back to top
map.symbol{ symbol='b' feat=FEAT_SHAFT_UP  info=8
         name="teleporter"
         on_walk="This appears to be a teleporter to the top level."
}       

-- EVIL, misleading (Maybe too evil)
--map.symbol{ symbol='c' feat=FEAT_FLOOR  info=6
--         name="pressure plate"
--         on_walk="You hear a faint click as you step on the floor here."
--}       

-- Dungeon layout
map.map
{
[[XXXXXXXXXXXXXXXXXXXXXXXXXXXXXXXXXXXXXXXXXXXXXXXXXXXXXXXXXXXXXXXXXXXXXXXXXXXXXXXXXXXXXXXXXXXXXXXXXXXXXXXXXXXXXXXXXXXXXXX]],
[[X.....................................................................................................................X]],
[[X.....................................................................................................................X]],
[[X.....................................................................................................................X]],
[[X.....................................................................................................................X]],
[[X.....................................................................................................................X]],
[[X.........................X.X..X......................................................................................X]],
[[X.........................X.X..X......................................................................................X]],
[[X.........................X.X..X......................................................................................X]],
[[X.........................X.X..X......................................................................................X]],
[[X.........................X.X..X......................................................................................X]],
[[X...................XXXXXXXDXDXXXXXXX....................XXXXXXXXXXXXXXXXXXXXXXXXX....................................X]],
[[X........................D.....D.........................Xb......................X....................................X]],
[[X...................XXXXXX..<..XXXXXXXXX.................X.......................X....................................X]],
[[X........................D.....D.......X.................X.......................X....................................X]],
[[X...................XXXXXXXDXDXXXXXXXX.XXXX..............X.......................X....................................X]],
[[X.........................X.X.X......X....X..............X.......................X....................................X]],
[[X.........................X.X.X.XXXX.XXXX.X..............X.......................X....................................X]],
[[X.........................X.X.X.D..X.D....X..............X.......................X....................................X]],
[[X.........................X.X.X.X..XXXXXXXX..............XXXXXXXXXXXXXXXXXXXXXXXXX....................................X]],
[[X.....................XXXXXDX.X.XXXX..................................................................................X]],
[[X.....................XaaaaaX.X.......................................................................................X]],
[[X.....................XaaaaaXDXXX.....................................................................................X]],
[[X.....................XaaaaaX...X.....................................................................................X]],
[[X.....................XaaaaaX...X.....................................................................................X]],
[[X.....................XDXXXXX...X.....................................................................................X]],
[[X...........................XXXXX.....................................................................................X]],
[[X.....................................................................................................................X]],
[[X.....................................................................................................................X]],
[[X.....................................................................................................................X]],
[[X.....................................................................................................................X]],
[[X.....................................................................................................................X]],
[[X.....................................................................................................................X]],
[[X.....................................................................................................................X]],
[[X.....................................................................................................................X]],
[[X.....................................................................................................................X]],
[[X.....................................................................................................................X]],
[[XXXXXXXXXXXXXXXXXXXXXXXXXXXXXXXXXXXXXXXXXXXXXXXXXXXXXXXXXXXXXXXXXXXXXXXXXXXXXXXXXXXXXXXXXXXXXXXXXXXXXXXXXXXXXXXXXXXXXXX]],
}

-- Starting position
map.set_player(13, 28)
