-- Hell
map.define("hell.map")

map.symbol{ symbol='X' feat=FEAT_LAVA_WALL info=6 }
map.symbol{ symbol='*' feat=FEAT_MAP_BORDER info=6 }
map.symbol{ symbol='.' feat=FEAT_DEEP_LAVA info=6 }
map.symbol{ symbol=',' feat=FEAT_ASH info=6 }
map.symbol{ symbol='a' feat=FEAT_DEEP_LAVA info=6 monster=RACE_GOZ }
map.symbol{ symbol='b' feat=FEAT_DEEP_LAVA info=6 monster=RACE_MEZ }
map.symbol{ symbol='c' feat=FEAT_SIGNPOST info=6 on_walk="The sign reads 'Welcome to Hell!'" }
map.symbol{ symbol='d' feat=FEAT_SIGNPOST info=6 on_walk="The sign reads 'This way to the lounge areas'" }
map.symbol{ symbol='e' feat=FEAT_SIGNPOST info=6 on_walk="The sign reads 'Castle of the Lord of the Underworld'" }
map.symbol{ symbol='f' feat=FEAT_HELL_SIGN info=6 }
map.symbol{ symbol='g' feat=FEAT_SIGNPOST info=6 on_walk="The sign reads 'This way to the emergency escape escalator!'" }
map.symbol{ symbol='h' feat=FEAT_SIGNPOST info=6  on_walk="The sign reads 'East not implemented yet. Don't go east.'" }

-- down staircase
-- map.symbol{ symbol='<' feat=FEAT_LESS info=6 }

map.map
{
[[******************************************************************************************************************]],
[[*XXXXXXXXXXXXXXXXXXXXXXXXXXXXXXXXXXXXXXXXXXXXXXXXXXXXXXXXXXXXXXXXXXXXXXXXXXXXXXXXXXXXXXXXXXXXXXXXXXXXXXXXXXXXXXXX*]],
[[*XXXXXXXXXXX..............XXXXXXXXXXXXXXXXXXXXXXXXXXXXXXXXXXXXXXXXXXXXXXXXXXXXXXXXXXXXXXXXXXXXXXXXXX............X*]],
[[*XXXXX............................XXXXXXXXXXXXXXXXXXXXXXXXXXXXXXXXXXXXXXXXXXXXXXXXXXXXXXXXXXXXX.................X*]],
[[*XXX.................................XXXXXXXXXXXXXXXXXXXXXXXXXXXXXXXXXXXXXXXXXXXXXXXXXXXXXX.....................X*]],
[[*XX.........................,.....,....XXXXXXXXXXXXXXXXXXXXXXXXXXXXXXXXXXXXXXXXXXXXXXXXXX.......................X*]],
[[*X......,,,,,,,,,,,,.........,..........XXXXXXXXXXXXXXXXXXXXXXXXXXXXXXXXXXXXXXXXXXXXXXX.........................X*]],
[[*X..........,,,,,,,,,,,,,...............XXXXXXXXXXXXXXXXXXXXXXXXXXXXXXXXXXXXXXXXXXXXXX..........................X*]],
[[*XX..............,,,,...............,...XXXXXXXXXXXXXXXXXXXXXXXXXXXXXXXXXXXXXXXXXXXXX...........................X*]],
[[*XX,,..........................,,......XXXXXXXXXXXXXXXXXXXXXXXXXXXXXXXXXXXXXXXXXXXXX............................X*]],
[[*XXX,,,......................,.,.......XXXXXXXXXXXXXXXXXXXXXXXXXXXXXXXXXXXXXXXXXXXX.............................X*]],
[[*XXXXXX.......................,.......XXXXXXXXXXXXXXXXXXXXXXXXXXXXXXXXXXXXXXXXXXXXX.............................X*]],
[[*XXXXXXXXXXXXX.......................XXXXXXXXXXXXXXXXXXXXXXXXXXXXXXXXXXXXXXXXXXXXX..............................X*]],
[[*XXXXXXXXXXXXXXXXXXX................XXXX....XXXXXXXXXXXXXXXXXXXXXXXXXXXXXXXXXXXXXX..............................X*]],
[[*XXXXXXXXXXXXXXXXXXXXXXXX..........XXX.........XXXXXXXXXXXXXXXXXXXXXXXXXXXXXXXXXX...............................X*]],
[[*XXXXXXXXXXXXXXXXXXXXXXX,.......,XXXX,..........XXXXXXXXXXXXXXXXXXXXXXXXXXXXXXXXX......................XX....XX.X*]],
[[*XXXXXXXXXXXXXXXXXXXXX,,,......XXXXX,,...........XXXXXXXXXXXXXXXXXXXXXXXXXXXXXXXX......................XXXXXXXX.X*]],
[[*XXXXXXXXXXXXXXXXXXXXXXXX,.......XXX......b.......XXXXXXXXXXXXXXXXXXXXXXXXXXXXXXX...................e..XXXXXXXX.X*]],
[[*XXXXXXXXXXXXXXXXXXXXXXXXXXX......XX...............h....................................................XXXXXX..X*]],
[[*XXXXXXXXXXXXXXXXXXXXXXXXXXXXX.....X...a.................................................................XXXXX..X*]],
[[*XXXXXXXXXXXXXXXXXXXXXXXXXXXXXXX...d.......c............................................................XXXXXX..X*]],
[[*XXXXXXXXXXXXXXXXXXXXXXXXXXXXXXX..................XXXXXXXXXXXXXXXXXXXXXXXXXXXXXXX......................XXXXXXXX.X*]],
[[*XXXXXXXXXXXXXXXXXXXXXXXXXXXXXX....XXXX........,,XXX.,...X..,..XXXXXXX...X..X...X......................XXXXXXXX.X*]],
[[*XXXXXXXXXXXXXXXXXXXXXXXXXXXXX....XXXgXXXXX..,,,XXXX.XXX.X.XXX...XXXXX.XXXX.X.X.X......................XX....XX.X*]],
[[*XXXXXXXXXXXXXXXXXXXXXXXXXXX.....XXXX.....XXXXXXX....XX......XXX.X...X.XXXX.X.X.X...............................X*]],
[[*XXXXXXXXXXXXXXXXXXXXXX..........XXX.XXXX.....XXX.X.XXX.XXXX...X...X.....,..X.X.XX..............................X*]],
[[*XXXXXXXXXXXXXXXXXXX..............XXX...XXXXX.....X.XXX.X..XXX.XXXXXXXXXXXXXX.X..X..............................X*]],
[[*XXXXXXXXXXXXX........................,.....XXXXXXX.XXX....X.......X......XXX.XX.XX.............................X*]],
[[*XXXXXX..............,,.........................XXX..XXXX..X.XXXXX.X.XXXX...X..X..X.............................X*]],
[[*XXXX..................,.........,,,..............XX..XXXXXX,X.....X....XXX.XX.XX.XX............................X*]],
[[*XXX..............................,,.....,.........XX..XXXXX.X...XXXXXX...X....XX..XX...........................X*]],
[[*XX......,,,,,,..................,,,,...............XX.X.....X...XX.....X.XXXXXXXX..XX..........................X*]],
[[*X...,......,,,,,.........,.......,..................X.X.XXXXXXXXXX.X.XXX,XXX....XX..XX.........................X*]],
[[*X....,........,,,,......,.......,,,,,...............X...X.......XX.X.XXX.....XX..XX..XXX.......................X*]],
[[*X................,,................,,,,..,..........X.X.X.XXXXX....X...XXXXXXXXXXXXX...XXX.....................X*]],
[[*XX.................,.................,..............X.X.X.X...XXXXXXXX...X.......XXXXX...XXXXX.................X*]],
[[*XXXX.................,...........,.......,.........XX.X...X.X...XXXXXXXX...XXXXX.XXXXXXX.....XXXXXX............X*]],
[[*XXXXXXXXXXX............,,..........,...,........XXXXX.XXXXX.XXX.X......XXXXX...X.XXX...XXXXX......XXXXXXXXXXXXXX*]],
[[*XXXXXXXXXXXXXXXXXXXXX.......................XXXXXXXXX..,....XXX...XXXX,......X.X.....X.....XXXXXX.............fX*]],
[[*XXXXXXXXXXXXXXXXXXXXXXXXXXXXXXXXXXXXXXXXXXXXXXXXXXXXXXXXXXXXXXXXXXXXXXXXXXXXXXXXXXXXXXXXXXXXXXXXXXXXXXXXXXXXXXXX*]],
[[******************************************************************************************************************]],
}

map.set_player(19, 43)
