-- Dragonball T: The Land of Karin

map.define("k_land.map")

map.symbol{ symbol='.' feat=FEAT_FLOOR info=3 }
map.symbol{ symbol='X' feat=FEAT_PERMA_WALL info=3 }
map.symbol{ symbol='#' feat=FEAT_PERMA_WALL info=3 }
map.symbol{ symbol='T' feat=FEAT_TREES info=3 }
map.symbol{ symbol='-' feat=FEAT_GRASS info=3
   flags = {
      MOVE_POST_DEST=function()
		player.calc_bonuses()
	end
   }
}
map.symbol{ symbol='<' feat=FEAT_LESS info=3 }
map.symbol{ symbol='>' feat=FEAT_MORE info=3
   flags = {
      MOVE_POST_DEST=function()
		player.calc_bonuses()
	end
   }
}

map.symbol{ symbol=' ' feat=FEAT_SKY info=3
   flags = {
      MOVE_POST_DEST=function()
		player.calc_bonuses()
	end
   }
}
map.symbol{ symbol='c' feat=FEAT_CLOUD info=3 }
map.symbol{ symbol='|' feat=FEAT_KARIN_TOWER info=3
   flags = {
      MOVE_POST_DEST=function()
		player.calc_bonuses()
	end
   }
}


map.symbol{ symbol='B' feat=FEAT_MAP_BORDER info=6 }

map.symbol{ symbol='a' feat=FEAT_GRASS info=3 monster=RACE_OOPA }
map.symbol{ symbol='b' feat=FEAT_GRASS info=3 monster=RACE_BOSA }

-- Dungeon layout
map.map
{
[[BBBBBBBBBBBBBBBBBBBBBBBBBBBBBBBBBBBBBBBBBBBBBBBBBBBBBBBBBBBBBBBBBBBBBBBBBBBBBBBB]],
[[B                XXXXXXXXXXXXXXXXXXXXXXXXXXXXXXXXXXXXXXXXX                     B]],
[[B                       XXXXXXXXXXXXX>XXXXXXXXXXXXX                            B]],
[[B                                    |                                         B]],
[[B                                    |                                         B]],
[[B                                    |                                         B]],
[[B                                    |                                         B]],
[[B                                    |                                         B]],
[[B                                    |                                         B]],
[[B                                    |                                         B]],
[[B                                    |                                         B]],
[[B                                    |                       cccc              B]],
[[B                                    |                      ccccc              B]],
[[B                                    |                       ccc               B]],
[[B                                    |                                         B]],
[[B                                    |                                         B]],
[[B                                    |                                         B]],
[[B                                    |                                         B]],
[[B                     cc             |                                         B]],
[[B                    cccc            |                                         B]],
[[B                     cc             |  cc                                     B]],
[[B                                    | ccccc                                   B]],
[[B                                    |   cc                                    B]],
[[B                                    |                                         B]],
[[B                                    |                                         B]],
[[B                                    |                                         B]],
[[B        ccc                         |                                         B]],
[[B        cccc                        |                                         B]],
[[B         cc                         |                                         B]],
[[B                                    |                                         B]],
[[B                                    |                                         B]],
[[B                                    |                                         B]],
[[B                                    |                                         B]],
[[B                                    |                                         B]],
[[B                                    |                                         B]],
[[B                                    |                          cc             B]],
[[B                                    |                         cccc            B]],
[[B                                    |                          cc             B]],
[[B                                    |                                         B]],
[[B                                    |                                         B]],
[[B                                    |                                         B]],
[[B                                    |                                         B]],
[[B                                    |                                         B]],
[[B                                    |                                         B]],
[[B                                    |                                         B]],
[[B                                    |                                         B]],
[[B                                    |                                         B]],
[[B                                    |            ccc                          B]],
[[B                                    |           ccccc                         B]],
[[B          ccc                       |            ccc                          B]],
[[B         ccccc                      |                                         B]],
[[B           cc                       |                                         B]],
[[B                                    |                                         B]],
[[B                                    |                                         B]],
[[B                                    |                                         B]],
[[B                                    |                       cccc              B]],
[[B                                    |                      ccccc              B]],
[[B                                    |                       ccc               B]],
[[B                                    |                                         B]],
[[B                                    |                                         B]],
[[B                                    |                                         B]],
[[B                                    |                                         B]],
[[B                     cc             |                                         B]],
[[B                    cccc            |                                         B]],
[[B                     cc             |  cc                                     B]],
[[B                                    | ccccc                                   B]],
[[B                                    |   cc                                    B]],
[[B                                    |                                         B]],
[[B                                    |                                         B]],
[[B                                    |                                         B]],
[[B        ccc                         |                                         B]],
[[B        cccc                        |                                         B]],
[[B         cc                         |                                         B]],
[[B                                    |                                         B]],
[[B                                    |                                         B]],
[[B                                    |                                         B]],
[[B                                    |                                         B]],
[[B                                    |                                         B]],
[[B                                    |                                         B]],
[[B                                    |                          cc             B]],
[[B                                    |                         cccc            B]],
[[B                                    |                          cc             B]],
[[B                                    |                                         B]],
[[B                                    |                                         B]],
[[B                                    |                                         B]],
[[B                                    |                                         B]],
[[B                                    |                                         B]],
[[B                                    |                                         B]],
[[B                                    |                                         B]],
[[B                                    |                                         B]],
[[B                                    |                                         B]],
[[B                                    |            ccc                          B]],
[[B                                    |           ccccc                         B]],
[[B          ccc                       |            ccc                          B]],
[[B         ccccc                      |                                         B]],
[[B           cc                       |                                         B]],
[[B                                    |                                         B]],
[[B                                    |                                         B]],
[[B                                    |                                         B]],
[[B                                    |                                         B]],
[[B                                    |                                         B]],
[[B                                    |                                         B]],
[[B                                    |                                         B]],
[[B                                    |                                         B]],
[[B                                    |                                         B]],
[[B                                    |                                         B]],
[[B                                    |                                         B]],
[[B                                    |                                         B]],
[[B                                    |                                         B]],
[[B                                    |                                         B]],
[[B                                    |                                         B]],
[[B                                    |                                         B]],
[[B                                    |                                         B]],
[[B                                    |                                         B]],
[[B                                    |                                         B]],
[[B                                    |                                         B]],
[[B                                    |                                         B]],
[[B                                    |                                         B]],
[[B                                    |                                         B]],
[[B    ---------       --              |                     -------------       B]],
[[BT-----------------------------------|-----------------------------------------B]],
[[BTTT-T---T-T---T-T--T--T-----T-------|--------TT-------T---TT--TTT---T--------TB]],
[[BTTTT---T-----T--T--T-T---T----------|------T-----T---------T-------T-T----TTTTB]],
[[BTTT--------T-------T---T---T----T---|-----T-----T--T---T-----TTT---T-----T-TTTB]],
[[BTT--T-T--------T-----T-----T-T---T--|----TT--T-TT--------T------T----T-T----TTB]],
[[BTT--T-T----T---T--------T--------T--|---T-T-------T-TTT----T--TT--T------T---TB]],
[[BTTT-----T-T----TT-T--------T---T----|---------T--T--T--------T-T--T-T----T--TTB]],
[[BTT-T-T--T--T-------T--T--T-T--------|------T-T--TT-------TT--T--T-------T--TTTB]],
[[BT------TT--T--T-T--T-T--T-----------|---------T-----TT-----T---T-T--T---T-TTTTB]],
[[BTT-T----T-----T-------TT------------|-----------T-T----T---------T------TTTTTTB]],
[[BT-T----T--T-T-------T--T-T--------a-------------------T---T----T---T-T-----TTTB]],
[[BT-T---T--T----T--T--T--T-T--------------------------------------T------------TB]],
[[BTT--------T-------T--T-T------------b------T---T------------T--------------<-TB]],
[[BTTTT----T---T-T--T-----T---TTT-------------T--T-----T-T-------------T--------TB]],
[[BTT---T-T----T---TT--T-T-------T---T----T-T---T---T------T---------T---T---TTTTB]],
[[BTT-T-T----T--T---T--T---TT-TT-T--TTT---T-----T-------TT----TT-T-T---T----TT-TTB]],
[[BT-T---T-T------T---TT-T-T--T-TT-----T---T-----T---T--T----------T--T----T--TTTB]],
[[BTTTT---T------T-T--------T-------T----T------T---T--T--T---T--T-TT-----TTTTTTTB]],
[[BTTTT------TT----------T--T-T--T--TT--T----T--T--T--------T------TT----T-T--TTTB]],
[[BTT--TT------T-T---T--T-TT-------T-------T---T-----TT-----T---T-T---T---T--T-TTB]],
[[BT---T--T------T--T-T------T--TT----T-T--------T-----T-T--T-------T--T-----T--TB]],
[[BTTT-T-T-----T-----T-T----T-----T----TT--T--T----T----T-----T--T-T------T---T-TB]],
[[BTTTTTTTTTTTTTTTTTTTTTTTTTTTTTTTTTTTTTTTTTTTTTTTTTTTTTTTTTTTTTTTTTTTTTTTTTTTTTTB]],
[[BBBBBBBBBBBBBBBBBBBBBBBBBBBBBBBBBBBBBBBBBBBBBBBBBBBBBBBBBBBBBBBBBBBBBBBBBBBBBBBB]],
}

map.level_size_to_map()

-- Starting position
map.set_player(132, 76)
