-- Dragonball T: Red Ribbon Army: Vault

map.define("vault.map")

map.symbol{ symbol='.' feat=FEAT_FLOOR info=6 }
map.symbol{ symbol='<' feat=FEAT_LESS info=3 }
map.symbol{ symbol='*' feat=FEAT_MAP_BORDER info=6 }
map.symbol{ symbol='X' feat=FEAT_PERMA_WALL info=6 }
map.symbol{ symbol='+' feat=FEAT_DOOR info=6 }
map.symbol{ symbol='G' feat=FEAT_GLASS_WALL info=6 }
map.symbol{ symbol='C' feat=FEAT_FLOOR info=6 monster=RACE_RRA_SHQ_CAM }

map.map
{
[[*******************************************************************]],
[[*XXXXXXXXXXXXXXXXXXXXXXXXXXXXXXXXXXXXXXXXXXXXXXXXXXXXXXXXXXXXXXXXX*]],
[[*XXXXXXXXXXXXXXXXXXXXXXXXXXXXXXXCXCXCXCXCXCXCXXXXXXXXXXXXXXXXXXXXX*]],
[[*XXXXXXXXXXXXXXXXXXXXXXXXXXXXXXXGXGXGXGXGXGXGXXXXXXXXXXXXXXXXXXXXX*]],
[[*XXXXXXXXXXXXXXXXXXXXXXXXXXXXXCG................GCXXXXXXXXXXXXXXXX*]],
[[*XXXXXXXXXXXXXXXXXXXXXXXXXXXXXXX...XGXGXGXGXGXX.XXXXXXXXXXXXXXXXXX*]],
[[*XXXXXXXXXXXXXXXXXXXXXXXXXXXXXCG...XCXCXCXCXCXX<XXXXXXXXXXXXXXXXXX*]],
[[*XXXXXXXXXXXXXXXXXXXXXXXXXXXXXXX...XXXXXXXXXXXXXXXXXXXXXXXXXXXXXXX*]],
[[*XXXXXXXXXXXXXXXXXXXXXXXXXXXXXXXX+XXXXXXXXXXXXXXXXXXXXXXXXXXXXXXXX*]],
[[*XXXXXXXXXXXXXXXXXXXXX.......................XXXXXXXXXXXXXXXXXXXXX*]],
[[*XXXXXXXXXXXXXXXXXXXXX.......................XXXXXXXXXXXXXXXXXXXXX*]],
[[*XXXXXXXXXXXXXXXXXXXXX.......................XXXXXXXXXXXXXXXXXXXXX*]],
[[*XXXXXXXXXXXXXXXXXXXXX.......................XXXXXXXXXXXXXXXXXXXXX*]],
[[*XXXXXXXXXXXXXXXXXXXXX.......................XXXXXXXXXXXXXXXXXXXXX*]],
[[*XXXXXXXXXXXXXXXXXXXXX.......................XXXXXXXXXXXXXXXXXXXXX*]],
[[*XXXXXXXXXXXXXXXXXXXXX.......................XXXXXXXXXXXXXXXXXXXXX*]],
[[*XXXXXXXXXXXXXXXXXXXXX.......................XXXXXXXXXXXXXXXXXXXXX*]],
[[*XXXXXXXXXXXXXXXXXXXXX.......................XXXXXXXXXXXXXXXXXXXXX*]],
[[*XXXXXXXXXXXXXXXXXXXXX.......................XXXXXXXXXXXXXXXXXXXXX*]],
[[*XXXXXXXXXXXXXXXXXXXXX.......................XXXXXXXXXXXXXXXXXXXXX*]],
[[*XXXXXXXXXXXXXXXXXXXXX.......................XXXXXXXXXXXXXXXXXXXXX*]],
[[*XXXXXXXXXXXXXXXXXXXXXXXXXXXXXXXXXXXXXXXXXXXXXXXXXXXXXXXXXXXXXXXXX*]],
[[*XXXXXXXXXXXXXXXXXXXXXXXXXXXXXXXXXXXXXXXXXXXXXXXXXXXXXXXXXXXXXXXXX*]],
[[*XXXXXXXXXXXXXXXXXXXXXXXXXXXXXXXXXXXXXXXXXXXXXXXXXXXXXXXXXXXXXXXXX*]],
[[*XXXXXXXXXXXXXXXXXXXXXXXXXXXXXXXXXXXXXXXXXXXXXXXXXXXXXXXXXXXXXXXXX*]],
[[*XXXXXXXXXXXXXXXXXXXXXXXXXXXXXXXXXXXXXXXXXXXXXXXXXXXXXXXXXXXXXXXXX*]],
[[*XXXXXXXXXXXXXXXXXXXXXXXXXXXXXXXXXXXXXXXXXXXXXXXXXXXXXXXXXXXXXXXXX*]],
[[*XXXXXXXXXXXXXXXXXXXXXXXXXXXXXXXXXXXXXXXXXXXXXXXXXXXXXXXXXXXXXXXXX*]],
[[*XXXXXXXXXXXXXXXXXXXXXXXXXXXXXXXXXXXXXXXXXXXXXXXXXXXXXXXXXXXXXXXXX*]],
[[*XXXXXXXXXXXXXXXXXXXXXXXXXXXXXXXXXXXXXXXXXXXXXXXXXXXXXXXXXXXXXXXXX*]],
[[*XXXXXXXXXXXXXXXXXXXXXXXXXXXXXXXXXXXXXXXXXXXXXXXXXXXXXXXXXXXXXXXXX*]],
[[*XXXXXXXXXXXXXXXXXXXXXXXXXXXXXXXXXXXXXXXXXXXXXXXXXXXXXXXXXXXXXXXXX*]],
[[*XXXXXXXXXXXXXXXXXXXXXXXXXXXXXXXXXXXXXXXXXXXXXXXXXXXXXXXXXXXXXXXXX*]],
[[*XXXXXXXXXXXXXXXXXXXXXXXXXXXXXXXXXXXXXXXXXXXXXXXXXXXXXXXXXXXXXXXXX*]],
[[*******************************************************************]],
}

map.set_player(6, 47)